1111111111111
1000000000001
1100001000001
1P0011E000001
1111111110111