1111111111111111111111
1111111000001110000011
10000000000C0000000001
1000111000000001100001
10C000000000C000000001
1000000000000000000001
100000100000000000C001
100P11E000000000011111
1111111111111111111111