1111111111111
100000000C001
1100001000001
1P0011E000001
1111111111111