1111111111111111111111
1111111000001110000C11
100000000000000C000001
100000000C000000000001
10C000000C000000000001
1000000000000000000001
100P001000000000C00001
100011E000000000011111
1111111111111111111111