1111111111111
100000000C001
100P001000001
100011E000001
1111111111111